R 1280        720

NO            ./textures/hitler.xpm

WE                        ./textures/door.xpm







SO                ./textures/eagle.xpm

EA       ./textures/banner.xpm
S        ./textures/barrel.xpm


F              200,200,200


C                 100,100,200



111 11111111111111111111111             111111
101111000111111111000000001             100001
10000000001111111110011111              100001
1111100000000000000011111111111111111111000011
1000000202020202000000000000000000000000000011
1000000000000000000000001111111101111111100001
11111000000000000000000011     101      100001
    100000000000000001011      101      100001
    11000000000000000001       101       10001
     10000000010000011111111111101111111110001
111111000000W000000000000000000000000000000011
1000000000000000001111111111111111111111111111
1111111111111111111111