R 1280 720

NO ./textures/banner.xpm

SO ./textures/hitler.xpm

WE ./textures/eagle.xpm

EA ./textures/wood.xpm

S ./textures/item_1.xpm

F 220,100,0

C 225,30,0

111111111111111111111
100001111111110000001
100000111111111000001
100000000000000000001
100000000000000000001
100000111111111000001
100000000000000000001
100000000000000000001
100000020000000000001
100000000000000000001
1011000000000000000N1
101100000000000000111
111111111111111111111